125
ATHLONE: HAZENDAL, CRAWFORD 
BELHAR: UNIBELL, LAVISTOWN 
BELLVILLE: STIKLAND, KUILS RIVER, SAREPTA, TYGERBERG, OOSTERZEE 
BLACKHEATH: KUILS RIVER, MELTONROSE 
BONTEHEUWEL: LANGA, LAVISTOWN, NETREG 
BRACKENFELL: STIKLAND, EIKENFONTEIN 
CAPE TOWN: ESPLANADE, WOODSTOCK, KOEBERG RD, MAITLAND 
CHRIS HANI: KUYASA 
CLAREMONT: NEWLANDS, HARFIELD RD 
CRAWFORD: ATHLONE, LANSDOWNE 
DAL JOSAFAT: HUGUENOT, MBEKWENI 
DIEPRIVIER: STEURHOF, HEATHFIELD 
DU TOIT: KOELENHOF, STELLENBOSCH 
EERSTE RIVER: MELTONROSE, FAURE, LYNEDOCH 
EIKENFONTEIN: BRACKENFELL, KRAAIFONTEIN 
ELSIES RIVER: VASCO, PAROW 
ESPLANADE: CAPE TOWN, YSTERPLAAT 
FALSE BAY: LAKESIDE, MUIZENBERG 
FAURE: EERSTE RIVER, FIRGROVE, LYNEDOCH 
FIRGROVE: FAURE, SOMERSET WEST 
FISH HOEK: KALK BAY, SUNNY COVE 
GLENCAIRN: SUNNY COVE, SIMON'S TOWN 
GOODWOOD: VASCO, THORNTON 
HARFIELD RD: CLAREMONT, KENILWORTH 
HAZENDAL: ATHLONE, PINELANDS 
HEATHFIELD: DIEPRIVIER, RETREAT 
HEIDEVELD: NETREG, NYANGA 
HUGUENOT: DAL JOSAFAT, PAARL 
KALK BAY: FISH HOEK, ST JAMES 
KAPTEINSKLIP: MITCHELLS PL.  
KENILWORTH: HARFIELD RD, WYNBERG 
KHAYELITSHA: KUYASA, NONKQUBELA 
KLAPMUTS: PAARL, MULDERSVLEI 
KOEBERG RD: CAPE TOWN, MAITLAND, SALT RIVER 
KOELENHOF: DU TOIT, MULDERSVLEI 
KRAAIFONTEIN: EIKENFONTEIN, MULDERSVLEI, FISANTEKRAAL 
KUILS RIVER: BELLVILLE, BLACKHEATH 
KUYASA: CHRIS HANI, KHAYELITSHA 
LAKESIDE: FALSE BAY, STEENBERG 
LANGA: BONTEHEUWEL, PINELANDS, MUTUAL 
LANSDOWNE: CRAWFORD, WETTON 
LAVISTOWN: BELHAR, BONTEHEUWEL 
LENTEGEUR: MITCHELLS PL., STOCK ROAD, PHILIPPI 
LYNEDOCH: EERSTE RIVER, FAURE, VLOTTENBURG  
MAITLAND: KOEBERG RD, NDABENI, WOLTEMADE 
MANDALAY: STOCK ROAD, NOLUNGILE 
MBEKWENI: DAL JOSAFAT, WELLINGTON 
MELTONROSE: BLACKHEATH, EERSTE RIVER 
MITCHELLS PL.: LENTEGEUR, KAPTEINSKLIP 
MOWBRAY: OBSERVATORY, ROSEBANK  
MUIZENBERG: FALSE BAY, ST JAMES  
MULDERSVLEI: KOELENHOF, KRAAIFONTEIN, KLAPMUTS 
MUTUAL: LANGA, WOLTEMADE, THORNTON 
NDABENI: MAITLAND, PINELANDS 
NETREG: BONTEHEUWEL, HEIDEVELD 
NEWLANDS: CLAREMONT, RONDEBOSCH 
NOLUNGILE: MANDALAY, NONKQUBELA 
NONKQUBELA: KHAYELITSHA, NOLUNGILE 
NYANGA: PHILIPPI, HEIDEVELD 
OBSERVATORY: MOWBRAY, SALT RIVER 
OTTERY: SOUTHFIELD, WETTON 
PAARDENEILAND: YSTERPLAAT, ESPLANADE 
PAARL: HUGUENOT, KLAPMUTS 
PAROW: ELSIES RIVER, TYGERBERG 
PENTECH: SAREPTA, UNIBELL 
PHILIPPI: LENTEGEUR, NYANGA 
PINELANDS: HAZENDAL, NDABENI, LANGA 
PLUMSTEAD: WITTEBOME, STEURHOF 
RETREAT: HEATHFIELD, STEENBERG, SOUTHFIELD 
ROSEBANK: MOWBRAY, RONDEBOSCH
RONDEBOSCH: ROSEBANK, NEWLANDS 
SALT RIVER: WOODSTOCK, OBSERVATORY, KOEBERG RD 
SAREPTA: PENTECH, BELLVILLE 
SIMON'S TOWN: GLENCAIRN 
SOMERSET WEST: VAN DER STEL, FIRGROVE 
SOUTHFIELD: OTTERY, HEATHFIELD 
STEENBERG: LAKESIDE, RETREAT 
STELLENBOSCH: DU TOIT, VLOTTENBURG 
STEURHOF: DIEPRIVIER, PLUMSTEAD 
STIKLAND: BELLVILLE, BRACKENFELL 
STOCK ROAD: MANDALAY, LENTEGEUR 
STRAND: VAN DER STEL 
ST JAMES: KALK BAY, MUIZENBERG 
SUNNY COVE: GLENCAIRN, FISH HOEK 
THORNTON: GOODWOOD, MUTUAL 
TYGERBERG: BELLVILLE, PAROW 
UNIBELL: BELHAR, PENTECH 
VAN DER STEL: STRAND, SOMERSET WEST 
VASCO: ELSIES RIVER, GOODWOOD 
VLOTTENBURG: LYNEDOCH, STELLENBOSCH 
WELLINGTON: MBEKWENI, MALAN 
WETTON: LANSDOWNE, OTTERY 
WITTEBOME: PLUMSTEAD, WYNBERG 
WOLTEMADE: MAITLAND, MUTUAL 
WOODSTOCK: CAPE TOWN, SALT RIVER, YSTERPLAAT 
WYNBERG: KENILWORTH, WITTEBOME 
YSTERPLAAT: ESPLANADE, WOLTEMADE, WOODSTOCK, KENTEMADE 
KENTEMADE: YSTERPLAAT, CENTURY CITY 
CENTURY CITY: KENTEMADE, AKASIA PARK 
AKASIA PARK: CENTURY CITY, MONTA VISTA 
MONTA VISTA: AKASIA PARK, DE GRENDAL 
DE GRENDAL: MONTA VISTA, AVONDALE 
AVONDALE: DE GRENDAL, OOSTERZEE 
OOSTERZEE: AVONDALE, BELLVILLE  
FISANTEKRAAL: MELLISH, KRAAIFONTEIN 
MELLISH: FISANTEKRAAL, MIKPUNT 
MIKPUNT: MELLISH, KLIPHEUWEL 
KLIPHEUWEL: MIKPUNT, WINTERVOGAL 
WINTERVOGAL: KLIPHEUWEL, KALBASKRAAL 
KALBASKRAAL: WINTERVOGAL, ABBOTSDALE 
ABBOTSDALE: KALBASKRAAL, MALMESBURY 
MALMESBURY: ABBOTSDALE 
MALAN: WELLINGTON, SOETENDAL 
SOETENDAL: MALAN, HERMON 
HERMON: SOETENDAL, VOËLVLEI 
VOËLVLEI: HERMON, GOUDA 
GOUDA: VOËLVLEI, TULBACHWEG 
TULBACHWEG: GOUDA, ARTOIS 
ARTOIS: TULBACHWEG, WOLSELEY 
WOLSELEY: ARTOIS, ROMANS RIVER 
ROMANS RIVER: WOLSELEY, BREE RIVER 
BREE RIVER: ROMANS RIVER, BOTHA 
BOTHA: BREE RIVER, GOUDINI ROAD 
GOUDINI ROAD: BOTHA, CHAVONNES 
CHAVONNES: GOUDINI ROAD, WORCESTER 
WORCESTER: CHAVONNES 